1111111111111
100100000P0C1
1000011111001
1E0011P000011
1111111111111