1111111111111
1E010000000C1
1000011111001
1E0011P000011
1111111111111